█████████████████████████████
█           █               █
█  $        █               D
█           ████████        █
█       █                   █
█       █           B       █
█    H  █                   █
█████████████████████████████